
NO       ./resources/walls_2/north.xpm
SO            ./resources/walls_2/south.xpm
WE         ./resources/walls_2/west.xpm
EA                            ./resources/walls_2/east.xpm

F          50  ,  50  ,  50   
C           255  ,   30    , 5 

        1111111111111111111111111
        1000000000110000000000001
        1011000001110000000000001
        1001000000000000000000001
111111111011000001110000000000001
100000000011000001110111111111111
11110111111111011100000000001
111101111111110111010100100010
110000001101010111000000100010
100000000000000011000000100010
100000000000000011010100100010
11000001110101011111011110S0111
11110111 1110101 1011110100010
11111111 1111111 111111111111000